15,15,15,15,15,15,15,15,15,15,15,15,15,15,15,15,15,15,15,15,15,15,15,15,15,15,15,15,15,15,15,15,15,15,15,15,15,15,15
15,0,0,0,0,0,0,0,0,0,0,0,0,0,0,0,0,0,0,0,0,0,0,0,0,0,0,0,0,0,0,0,0,0,0,0,0,0,15
15,0,8,9,0,8,9,0,8,9,0,8,9,0,8,9,0,8,9,0,8,9,0,8,9,0,8,9,0,8,9,0,8,9,0,8,9,0,15
15,0,48,49,0,48,49,0,48,49,0,48,49,0,48,49,0,48,49,0,48,49,0,48,49,0,48,49,0,48,49,0,48,49,0,48,49,0,15
15,0,0,0,0,0,0,0,0,0,0,0,0,0,0,0,0,0,0,0,0,0,0,0,0,0,0,0,0,0,0,0,0,0,0,0,0,0,15
15,0,8,9,0,8,9,0,8,9,0,8,9,0,8,9,0,8,9,0,8,9,0,8,9,0,8,9,0,8,9,0,8,9,0,8,9,0,15
15,0,48,49,0,48,49,0,48,49,0,48,49,0,48,49,0,48,49,0,48,49,0,48,49,0,48,49,0,48,49,0,48,49,0,48,49,0,15
15,0,0,0,0,0,0,0,0,0,0,0,0,0,0,0,0,0,0,0,0,0,0,0,0,0,0,0,0,0,0,0,0,0,0,0,0,0,15
15,0,8,9,0,8,9,0,8,9,0,8,9,0,8,9,0,8,9,0,8,9,0,8,9,0,8,9,0,8,9,0,8,9,0,8,9,0,15
15,0,48,49,0,48,49,0,48,49,0,48,49,0,48,49,0,48,49,0,48,49,0,48,49,0,48,49,0,48,49,0,48,49,0,48,49,0,15
15,0,0,0,0,0,0,0,0,0,0,0,0,0,0,0,0,0,0,0,0,0,0,0,0,0,0,0,0,0,0,0,0,0,0,0,0,0,15
15,0,8,9,0,8,9,0,8,9,0,8,9,0,8,9,14,8,9,14,8,9,14,8,9,0,8,9,0,8,9,0,8,9,0,8,9,0,15
15,0,48,49,0,48,49,0,48,49,0,48,49,0,48,49,55,48,49,55,48,49,55,48,49,0,48,49,0,48,49,0,48,49,0,48,49,0,15
15,0,0,0,0,0,0,0,0,0,0,0,0,0,0,0,0,0,0,0,0,0,0,0,0,0,0,0,0,0,0,0,0,0,0,0,0,0,15
15,0,8,9,0,8,9,0,8,9,0,8,9,0,8,9,0,8,9,0,8,9,0,8,9,0,8,9,0,8,9,0,8,9,0,8,9,0,15
15,0,48,49,0,48,49,0,48,49,0,48,49,0,48,49,0,48,49,0,48,49,0,48,49,0,48,49,0,48,49,0,48,49,0,48,49,0,15
15,0,0,0,0,0,0,0,0,0,0,0,0,0,0,0,0,0,0,0,0,0,0,0,0,0,0,0,0,0,0,0,0,0,0,0,0,0,15
15,0,8,9,0,8,9,0,8,9,0,8,9,0,8,9,0,8,9,0,8,9,0,8,9,0,8,9,0,8,9,0,8,9,0,8,9,0,15
15,0,48,49,0,48,49,0,48,49,0,48,49,0,48,49,0,48,49,0,48,49,0,48,49,0,48,49,0,48,49,0,48,49,0,48,49,0,15
15,0,0,0,0,0,0,0,0,0,0,0,0,0,0,0,0,0,0,0,0,0,0,0,0,0,0,0,0,0,0,0,0,0,0,0,0,0,15
15,0,8,9,0,8,9,0,8,9,0,8,9,0,8,9,15,8,9,0,8,9,0,8,9,0,8,9,0,8,9,15,8,9,0,8,9,0,15
15,0,48,49,0,48,49,0,48,49,0,48,49,0,48,49,55,48,49,0,48,49,0,48,49,0,48,49,0,48,49,55,48,49,0,48,49,0,15
15,0,0,0,0,0,0,0,0,0,0,0,0,0,55,55,0,0,0,0,0,0,0,0,0,0,0,0,0,55,55,0,55,55,0,55,55,0,15
15,0,8,9,15,8,9,0,8,9,0,8,9,0,8,9,15,8,9,0,8,9,0,8,9,0,8,9,0,8,9,0,8,9,0,8,9,15,15
15,0,48,49,55,48,49,0,48,49,0,48,49,0,48,49,55,48,49,0,48,49,0,48,49,0,48,49,0,48,49,0,48,49,0,48,49,55,15
15,0,0,0,0,55,55,0,0,0,0,0,0,0,0,0,0,0,0,0,0,0,0,0,0,0,55,55,0,0,0,0,0,0,0,0,0,0,15
15,0,8,9,0,8,9,0,8,9,0,8,9,0,8,9,0,8,9,0,8,9,0,8,9,0,8,9,0,8,9,0,8,9,0,8,9,0,15
15,0,48,49,0,48,49,0,48,49,0,48,49,0,48,49,0,48,49,0,48,49,0,48,49,0,48,49,0,48,49,0,48,49,0,48,49,0,15
15,0,15,15,0,0,0,0,0,0,0,0,0,0,0,0,0,0,0,0,0,0,0,0,0,0,0,0,0,0,0,0,0,0,0,0,0,0,15
15,15,15,15,15,15,15,15,15,15,15,15,15,15,15,15,15,15,15,15,15,15,15,15,15,15,15,15,15,15,15,15,15,15,15,15,15,15,15
15,15,15,15,15,15,15,15,15,15,15,15,15,15,15,15,15,15,15,15,15,15,15,15,15,15,15,15,15,15,15,15,15,15,15,15,15,15,15
15,0,0,0,0,15,55,0,0,0,0,0,0,0,0,0,0,0,0,0,0,0,0,15,55,0,0,0,0,0,0,0,0,0,0,0,0,0,15
15,0,10,11,0,10,11,0,10,11,0,10,11,0,10,11,0,10,11,0,10,11,55,10,11,0,10,11,0,10,11,0,10,11,0,10,11,0,15
15,0,50,51,0,50,51,0,50,51,0,50,51,0,50,51,0,50,51,0,50,51,55,50,51,0,50,51,0,50,51,0,50,51,0,50,51,0,15
15,0,0,0,0,15,55,0,0,0,0,0,0,0,0,0,0,0,0,0,0,0,0,0,0,0,0,0,0,0,0,0,0,0,0,0,0,0,15
15,0,10,11,0,10,11,0,10,11,0,10,11,0,10,11,0,10,11,0,10,11,55,10,11,0,10,11,0,10,11,0,10,11,0,10,11,0,15
15,0,50,51,0,50,51,0,50,51,0,50,51,0,50,51,0,50,51,0,50,51,55,50,51,0,50,51,0,50,51,0,50,51,0,50,51,0,15
15,0,0,0,0,15,55,0,0,0,0,0,0,0,0,0,0,0,0,0,15,55,0,0,0,0,0,0,0,0,0,0,0,0,0,0,0,0,15
15,0,10,11,15,10,11,0,10,11,0,10,11,0,10,11,0,10,11,0,10,11,0,10,11,0,10,11,0,10,11,0,10,11,0,10,11,0,15
15,0,50,51,55,50,51,0,50,51,0,50,51,0,50,51,0,50,51,0,50,51,0,50,51,0,50,51,0,50,51,0,50,51,0,50,51,0,15
15,0,0,0,0,0,0,0,0,0,0,0,0,0,0,0,0,0,0,0,0,0,0,0,0,0,0,0,0,0,0,0,0,0,0,0,0,0,15
15,0,10,11,0,10,11,0,10,11,0,10,11,0,10,11,0,10,11,0,10,11,0,20,21,0,10,11,0,10,11,0,10,11,0,10,11,0,15
15,0,50,51,0,50,51,0,50,51,0,50,51,0,50,51,0,50,51,0,50,51,0,60,61,0,50,51,0,50,51,0,50,51,0,50,51,0,15
15,0,0,0,0,0,0,0,0,0,0,0,0,0,0,0,0,0,0,0,0,0,0,0,0,0,0,0,0,0,0,0,15,55,0,15,55,0,15
15,0,10,11,0,10,11,0,10,11,0,10,11,0,10,11,0,10,11,0,10,11,0,10,11,0,10,11,0,10,11,0,10,11,0,10,11,0,15
15,0,50,51,0,50,51,0,50,51,0,50,51,0,50,51,0,50,51,0,50,51,0,50,51,0,50,51,0,50,51,0,50,51,0,50,51,0,15
15,0,0,0,0,0,0,0,0,0,0,0,0,0,0,0,0,0,0,0,0,0,0,0,0,0,0,0,0,0,0,0,0,0,0,0,0,0,15
15,0,10,11,0,10,11,0,10,11,0,10,11,0,10,11,0,10,11,0,10,11,0,10,11,0,10,11,0,10,11,0,10,11,0,10,11,0,15
15,0,50,51,0,50,51,0,50,51,0,50,51,0,50,51,0,50,51,0,50,51,0,50,51,0,50,51,0,50,51,0,50,51,0,50,51,0,15
15,0,0,0,0,0,0,0,0,0,0,0,0,0,0,0,0,0,0,0,0,0,0,0,0,0,0,0,0,0,0,0,0,0,0,0,0,0,15
15,0,10,11,0,10,11,15,10,11,55,10,11,0,10,11,0,10,11,0,10,11,0,10,11,0,10,11,0,10,11,0,10,11,0,10,11,0,15
15,0,50,51,0,50,51,15,50,51,55,50,51,0,50,51,0,50,51,0,50,51,0,50,51,0,50,51,0,50,51,0,50,51,0,50,51,0,15
15,0,0,0,0,0,0,0,0,0,0,15,55,0,0,0,0,0,0,0,0,0,0,0,0,0,0,0,0,0,0,0,0,0,0,0,0,0,15
15,0,10,11,0,10,11,55,10,11,0,10,11,0,10,11,0,10,11,0,10,11,55,10,11,0,10,11,0,10,11,0,10,11,0,10,11,0,15
15,0,50,51,0,50,51,55,50,51,0,50,51,0,50,51,0,50,51,0,50,51,55,50,51,0,50,51,0,50,51,0,50,51,0,50,51,0,15
15,0,0,0,0,0,0,0,0,0,0,15,55,0,0,0,0,0,0,0,0,0,0,0,0,0,0,0,0,0,0,0,0,0,0,0,0,0,15
15,0,10,11,0,10,11,0,10,11,15,10,11,0,10,11,0,10,11,0,10,11,0,10,11,0,10,11,0,10,11,0,10,11,0,10,11,0,15
15,0,50,51,0,50,51,0,50,51,15,50,51,0,50,51,0,50,51,0,50,51,0,50,51,0,50,51,0,50,51,0,50,51,0,50,51,0,15
15,0,0,0,0,0,0,0,0,0,0,0,0,0,0,0,0,0,0,0,0,0,0,0,0,0,0,0,0,0,0,0,0,0,0,0,0,0,15
15,15,15,15,15,15,15,15,15,15,15,15,15,15,15,15,15,15,15,15,15,15,15,15,15,15,15,15,15,15,15,15,15,15,15,15,15,15,15
15,15,15,15,15,15,15,15,15,15,15,15,15,15,15,15,15,15,15,15,15,15,15,15,15,15,15,15,15,15,15,15,15,15,15,15,15,15,15
15,0,0,0,0,0,0,0,0,0,0,0,0,0,0,0,0,0,0,0,0,0,0,0,0,0,0,0,0,0,0,0,58,59,0,0,0,0,15
15,0,18,19,0,18,19,0,18,19,0,18,19,0,18,19,0,18,19,0,18,19,0,18,19,0,18,19,0,58,59,0,18,19,15,18,19,0,15
15,0,58,59,0,58,59,0,58,59,0,58,59,0,58,59,0,58,59,0,58,59,0,58,59,0,58,59,0,18,19,0,58,59,15,58,59,0,15
15,0,0,0,0,0,0,0,0,0,0,0,0,0,0,0,0,0,0,0,0,0,0,0,0,0,0,0,0,58,59,0,0,0,0,0,0,0,15
15,0,18,19,0,18,19,0,18,19,0,18,19,0,18,19,0,18,19,0,18,19,0,18,19,0,18,19,0,18,19,55,18,19,0,18,19,55,15
15,0,58,59,0,58,59,0,58,59,0,58,59,0,58,59,0,58,59,0,58,59,0,58,59,0,58,59,0,58,59,55,58,59,0,58,59,55,15
15,0,0,0,0,0,0,0,0,0,0,0,0,0,0,0,0,0,0,0,0,0,0,0,0,0,0,0,0,0,0,0,0,0,0,0,0,0,15
15,0,18,19,0,18,19,0,18,19,55,18,19,0,18,19,0,18,19,0,18,19,0,18,19,0,18,19,0,18,19,0,18,19,0,18,19,0,15
15,0,58,59,0,58,59,0,58,59,55,58,59,0,58,59,0,58,59,0,58,59,0,58,59,0,58,59,0,58,59,0,58,59,0,58,59,0,15
15,0,0,0,0,0,0,0,0,0,0,0,0,0,0,0,0,0,0,0,0,0,0,18,19,0,0,0,0,18,19,0,0,0,0,0,0,0,15
15,0,18,19,15,18,19,0,18,19,0,58,59,0,18,19,15,18,19,0,18,19,0,58,59,0,18,19,0,58,59,0,18,19,0,18,19,0,15
15,0,58,59,15,58,59,0,58,59,0,18,19,0,58,59,15,58,59,0,58,59,0,18,19,0,58,59,0,18,19,0,58,59,0,58,59,0,15
15,0,0,0,0,0,0,0,0,0,0,58,59,0,0,0,0,0,0,0,0,0,0,58,59,0,0,0,0,0,0,0,0,0,0,0,0,0,15
15,55,18,19,15,18,19,0,18,19,0,18,19,0,18,19,0,18,19,0,18,19,0,18,19,0,18,19,0,18,19,0,18,19,0,18,19,0,15
15,55,58,59,15,58,59,0,58,59,0,58,59,0,58,59,0,58,59,0,58,59,0,58,59,0,58,59,0,58,59,0,58,59,0,58,59,0,15
15,0,0,0,0,0,0,0,0,0,0,18,19,0,0,0,0,0,0,0,0,0,0,0,0,0,0,0,0,0,0,0,0,0,0,0,0,0,15
15,0,18,19,0,18,19,0,18,19,0,58,59,0,18,19,0,18,19,0,18,19,0,18,19,0,18,19,0,18,19,0,18,19,0,18,19,0,15
15,0,58,59,0,58,59,0,58,59,0,18,19,0,58,59,0,58,59,0,58,59,0,58,59,0,58,59,0,58,59,0,58,59,0,58,59,0,15
15,0,0,0,0,0,0,0,0,0,0,0,0,0,0,0,0,0,0,0,0,0,0,0,0,0,0,0,0,0,0,0,0,0,0,0,0,0,15
15,0,18,19,0,18,19,0,18,19,55,18,19,0,18,19,0,18,19,0,58,59,0,18,19,0,18,19,0,18,19,55,18,19,0,18,19,0,15
15,0,58,59,0,58,59,0,58,59,55,58,59,0,58,59,0,58,59,0,18,19,0,58,59,0,58,59,0,58,59,55,58,59,0,58,59,0,15
15,0,0,0,0,0,0,0,0,0,0,0,0,0,0,0,0,0,0,0,58,59,0,0,0,0,0,0,0,0,0,0,0,0,0,0,0,0,15
15,0,18,19,0,18,19,15,18,19,0,18,19,0,18,19,0,18,19,0,18,19,0,18,19,0,18,19,0,18,19,0,18,19,0,18,19,0,15
15,0,58,59,0,58,59,15,58,59,0,58,59,0,58,59,0,58,59,0,58,59,0,58,59,0,58,59,0,58,59,0,58,59,0,58,59,0,15
15,0,0,0,0,0,0,0,0,0,0,0,0,0,0,0,0,0,0,0,18,19,0,0,0,0,0,0,0,0,0,0,0,0,0,0,0,0,15
15,0,18,19,0,18,19,0,18,19,0,18,19,0,18,19,0,18,19,0,58,59,0,18,19,0,18,19,0,18,19,0,18,19,0,18,19,0,15
15,0,58,59,0,58,59,0,58,59,0,58,59,0,58,59,0,58,59,0,18,19,0,58,59,0,58,59,0,58,59,0,58,59,0,58,59,0,15
15,0,0,0,0,0,0,0,0,0,0,0,0,0,0,0,0,0,0,0,0,0,0,0,0,0,0,0,0,0,0,0,0,0,0,0,0,0,15
15,15,15,15,15,15,15,15,15,15,15,15,15,15,15,15,15,15,15,15,15,15,15,15,15,15,15,15,15,15,15,15,15,15,15,15,15,15,15
15,15,15,15,15,15,15,15,15,15,15,15,15,15,15,15,15,15,15,15,15,15,15,15,15,15,15,15,15,15,15,15,15,15,15,15,15,15,15
15,0,0,0,0,0,0,0,0,0,0,0,0,0,0,0,0,0,0,0,0,0,0,16,57,0,0,0,0,0,0,0,0,0,0,0,0,0,15
15,0,16,17,0,16,17,0,16,17,0,16,17,0,16,17,0,16,17,0,16,17,0,16,17,0,16,17,0,16,17,0,16,17,0,16,17,0,15
15,0,56,57,0,56,57,0,56,57,0,56,57,0,56,57,0,56,57,0,56,57,0,56,57,0,56,57,0,56,57,0,56,57,0,56,57,0,15
15,0,0,0,0,0,0,0,16,57,0,0,0,0,0,0,0,0,0,0,0,0,0,0,0,0,0,0,0,16,57,0,0,0,0,0,0,0,15
15,0,16,17,0,16,17,0,16,17,0,16,17,0,16,17,0,16,17,0,16,17,0,16,17,0,16,17,0,16,17,0,16,17,0,16,17,0,15
15,0,56,57,0,56,57,0,56,57,0,56,57,0,56,57,0,56,57,0,56,57,0,56,57,0,56,57,0,56,57,0,56,57,0,56,57,0,15
15,0,0,0,0,0,0,0,16,57,0,0,0,0,0,0,0,0,0,0,0,0,0,0,0,0,0,0,0,16,57,0,0,0,0,0,0,0,15
15,0,16,17,0,16,17,16,16,17,0,16,17,0,16,17,0,16,17,0,16,17,0,16,17,0,16,17,0,16,17,16,16,17,0,16,17,0,15
15,0,56,57,0,56,57,57,56,57,0,56,57,0,56,57,0,56,57,0,56,57,0,56,57,0,56,57,0,56,57,57,56,57,0,56,57,0,15
15,0,0,0,0,0,0,0,0,0,0,0,0,0,16,57,0,0,0,0,0,0,0,0,0,0,0,0,0,0,0,0,0,0,0,0,0,0,15
15,0,16,17,0,16,17,0,16,17,0,16,17,0,16,17,0,16,17,0,16,17,0,16,17,0,16,17,0,16,17,0,16,17,0,16,17,0,15
15,0,56,57,0,56,57,0,56,57,0,56,57,0,56,57,0,56,57,0,56,57,0,56,57,0,56,57,0,56,57,0,56,57,0,56,57,0,15
15,0,0,0,0,0,0,0,0,0,0,0,0,0,16,57,0,0,0,0,0,0,0,0,0,0,0,0,0,0,0,0,0,0,0,0,0,0,15
15,0,16,17,0,16,17,0,16,17,0,16,17,16,16,17,16,16,17,0,16,17,0,16,17,0,16,17,0,16,17,0,16,17,0,16,17,0,15
15,0,56,57,0,56,57,0,56,57,0,56,57,57,56,57,57,56,57,0,56,57,0,56,57,0,56,57,0,56,57,0,56,57,0,56,57,0,15
15,0,0,0,0,0,0,0,0,0,0,0,0,0,0,0,0,0,0,0,0,0,0,0,0,0,0,0,0,0,0,0,0,0,0,0,0,0,15
15,0,16,17,0,16,17,0,16,17,0,16,17,0,16,17,0,16,17,0,16,17,0,16,17,16,16,17,16,16,17,0,16,17,0,16,17,0,15
15,0,56,57,0,56,57,0,56,57,0,56,57,0,56,57,0,56,57,0,56,57,0,56,57,57,56,57,57,56,57,0,56,57,0,56,57,0,15
15,0,0,0,0,0,0,0,0,0,0,0,0,0,0,0,0,0,0,0,0,0,0,0,0,0,16,57,0,0,0,0,0,0,0,0,0,0,15
15,0,16,17,0,16,17,0,16,17,0,16,17,0,16,17,0,16,17,0,16,17,0,16,17,0,16,17,0,16,17,0,16,17,0,16,17,0,15
15,0,56,57,0,56,57,0,56,57,0,56,57,0,56,57,0,56,57,0,56,57,0,56,57,0,56,57,0,56,57,0,56,57,0,56,57,0,15
15,0,0,0,0,0,0,0,0,0,0,0,0,0,0,0,0,0,0,0,0,0,0,0,0,0,16,57,0,0,0,0,0,0,0,0,0,0,15
15,0,16,17,16,16,17,16,16,17,0,16,17,0,16,17,0,16,17,0,16,17,0,16,17,0,16,17,0,16,17,0,16,17,0,16,17,0,15
15,0,56,57,57,56,57,57,56,57,0,56,57,0,56,57,0,56,57,0,56,57,0,56,57,0,56,57,0,56,57,0,56,57,0,56,57,0,15
15,0,0,0,0,0,0,0,0,0,0,0,0,0,0,0,0,0,0,0,0,0,0,0,0,0,0,0,0,0,0,0,0,0,0,0,0,0,15
15,0,16,17,0,16,17,0,16,17,0,16,17,0,16,17,0,16,17,0,16,17,0,16,17,0,16,17,0,16,17,0,16,17,0,16,17,0,15
15,0,56,57,0,56,57,0,56,57,0,56,57,0,56,57,0,56,57,0,56,57,0,56,57,0,56,57,0,56,57,0,56,57,0,56,57,0,15
15,0,0,0,0,0,0,0,0,0,0,0,0,0,16,57,0,0,0,0,0,0,0,0,0,0,0,0,0,0,0,0,0,0,0,0,0,0,15
15,15,15,15,15,15,15,15,15,15,15,15,15,15,15,15,15,15,15,15,15,15,15,15,15,15,15,15,15,15,15,15,15,15,15,15,15,15,15
15,15,15,15,15,15,15,15,15,15,15,15,15,15,15,15,15,15,15,15,15,15,15,15,15,15,15,15,15,15,15,15,15,15,15,15,15,15,15
15,0,0,0,0,0,0,0,0,0,0,0,0,0,0,0,0,0,0,0,0,0,0,0,0,0,0,0,0,0,0,0,0,0,0,0,0,0,15
15,0,49,48,0,8,9,0,49,48,0,8,9,0,49,48,0,8,9,0,49,48,0,8,9,0,49,48,0,8,9,0,49,48,0,8,9,0,15
15,0,48,49,0,9,8,0,48,49,0,9,8,0,48,49,0,9,8,0,48,49,0,9,8,0,48,49,0,9,8,0,48,49,0,9,8,0,15
15,0,0,0,0,0,0,0,0,0,0,0,0,0,0,0,0,0,0,0,0,0,0,0,0,0,0,0,0,0,0,0,0,0,0,0,0,0,15
15,0,8,9,0,49,48,0,8,9,0,49,48,0,8,9,0,49,48,0,8,9,0,49,48,0,8,9,0,49,48,0,8,9,0,49,48,0,15
15,0,9,8,0,48,49,0,9,8,0,48,49,0,9,8,0,48,49,0,9,8,0,48,49,0,9,8,0,48,49,0,9,8,0,48,49,0,15
15,0,0,0,0,0,0,0,0,0,0,0,0,0,0,0,0,0,0,0,0,0,0,0,0,0,0,0,0,0,0,0,0,0,0,0,0,0,15
15,0,49,48,0,8,9,0,49,48,0,8,9,0,49,48,0,8,9,0,49,48,0,8,9,0,49,48,0,8,9,0,49,48,0,8,9,0,15
15,0,48,49,0,9,8,0,48,49,0,9,8,0,48,49,0,9,8,0,48,49,0,9,8,0,48,49,0,9,8,0,48,49,0,9,8,0,15
15,0,0,0,0,0,0,0,0,0,0,0,0,0,0,0,0,0,0,0,0,0,0,0,0,0,0,0,0,0,0,0,0,0,0,0,0,0,15
15,0,8,9,0,49,48,0,8,9,0,49,48,0,8,9,0,49,48,0,8,9,0,49,48,0,8,9,0,49,48,0,8,9,0,49,48,0,15
15,0,9,8,0,48,49,0,9,8,0,48,49,0,9,8,0,48,49,0,9,8,0,48,49,0,9,8,0,48,49,0,9,8,0,48,49,0,15
15,0,0,0,0,0,0,0,0,0,0,0,0,0,0,0,0,0,0,0,0,0,0,0,0,0,0,0,0,0,0,0,0,0,0,0,0,0,15
15,0,49,48,0,8,9,0,49,48,0,8,9,0,49,48,0,8,9,0,49,48,0,8,9,0,49,48,0,8,9,0,49,48,0,8,9,0,15
15,0,48,49,0,9,8,0,48,49,0,9,8,0,48,49,0,9,8,0,48,49,0,9,8,0,48,49,0,9,8,0,48,49,0,9,8,0,15
15,0,0,0,0,0,0,0,0,0,0,0,0,0,0,0,0,0,0,0,0,0,0,0,0,0,0,0,0,0,0,0,0,0,0,0,0,0,15
15,0,8,9,0,49,48,0,8,9,0,49,48,0,8,9,0,49,48,0,8,9,0,49,48,0,8,9,0,49,48,0,8,9,0,49,48,0,15
15,0,9,8,0,48,49,0,9,8,0,48,49,0,9,8,0,48,49,0,9,8,0,48,49,0,9,8,0,48,49,0,9,8,0,48,49,0,15
15,0,0,0,0,0,0,0,0,0,0,0,0,0,0,0,0,0,0,0,0,0,0,0,0,0,0,0,0,0,0,0,0,0,0,0,0,0,15
15,0,49,48,0,8,9,0,49,48,0,8,9,0,49,48,0,8,9,0,49,48,0,8,9,0,49,48,0,8,9,0,49,48,0,8,9,0,15
15,0,48,49,0,9,8,0,48,49,0,9,8,0,48,49,0,9,8,0,48,49,0,9,8,0,48,49,0,9,8,0,48,49,0,9,8,0,15
15,0,0,0,0,0,0,0,0,0,0,0,0,0,0,0,0,0,0,0,0,0,0,0,0,0,0,0,0,0,0,0,0,0,0,0,0,0,15
15,0,8,9,0,49,48,0,8,9,0,49,48,0,8,9,0,49,48,0,8,9,0,49,48,0,8,9,0,49,48,0,8,9,0,49,48,0,15
15,0,9,8,0,48,49,0,9,8,0,48,49,0,9,8,0,48,49,0,9,8,0,48,49,0,9,8,0,48,49,0,9,8,0,48,49,0,15
15,0,0,0,0,0,0,0,0,0,0,0,0,0,0,0,0,0,0,0,0,0,0,0,0,0,0,0,0,0,0,0,0,0,0,0,0,0,15
15,0,49,48,0,8,9,0,49,48,0,8,9,0,49,48,0,8,9,0,49,48,0,8,9,0,49,48,0,8,9,0,49,48,0,8,9,0,15
15,0,48,49,0,9,8,0,48,49,0,9,8,0,48,49,0,9,8,0,48,49,0,9,8,0,48,49,0,9,8,0,48,49,0,9,8,0,15
15,0,0,0,0,0,0,0,0,0,0,0,0,0,0,0,0,0,0,0,0,0,0,0,0,0,0,0,0,0,0,0,0,0,0,0,0,0,15
15,15,15,15,15,15,15,15,15,15,15,15,15,15,15,15,15,15,15,15,15,15,15,15,15,15,15,15,15,15,15,15,15,15,15,15,15,15,15
15,15,15,15,15,15,15,15,15,15,15,15,15,15,15,15,15,15,15,15,15,15,15,15,15,15,15,15,15,15,15,15,15,15,15,15,15,15,15
15,0,0,0,0,0,0,0,0,0,0,0,0,0,0,0,0,15,15,0,0,0,0,0,0,0,0,0,0,0,0,0,0,0,0,0,0,0,15
15,0,12,52,0,12,52,0,12,52,0,12,52,0,12,52,55,12,52,0,12,52,0,12,52,0,12,52,0,12,52,0,12,52,0,12,52,0,15
15,0,52,12,0,52,12,0,52,12,0,52,12,0,52,12,55,52,12,0,52,12,0,52,12,0,52,12,0,52,12,0,52,12,0,52,12,0,15
15,0,0,0,0,0,0,0,0,0,0,0,0,0,15,15,0,0,0,0,0,0,0,0,0,0,0,0,0,0,0,0,0,0,0,0,0,0,15
15,0,12,52,0,12,52,0,12,52,0,12,52,55,12,52,0,12,52,0,12,52,0,12,52,0,12,52,0,12,52,0,12,52,0,12,52,0,15
15,0,52,12,0,52,12,0,52,12,0,52,12,55,52,12,0,52,12,0,52,12,0,52,12,0,52,12,0,52,12,0,52,12,0,52,12,0,15
15,0,0,0,0,0,0,0,0,0,0,0,0,0,0,0,0,0,0,0,0,0,0,0,0,0,0,0,0,15,15,0,0,0,0,0,0,0,15
15,0,12,52,0,12,52,0,12,52,0,12,52,0,12,52,0,12,52,0,12,52,0,12,52,0,12,52,0,12,52,0,12,52,0,12,52,0,15
15,0,52,12,0,52,12,0,52,12,0,52,12,0,52,12,0,52,12,0,52,12,0,52,12,0,52,12,0,52,12,0,52,12,0,52,12,0,15
15,0,0,0,0,0,0,0,0,0,0,0,0,0,0,0,0,0,0,0,0,0,0,0,0,0,15,15,0,0,0,0,0,0,0,0,0,0,15
15,0,12,52,0,12,52,55,12,52,55,12,52,0,12,52,0,12,52,0,12,52,0,12,52,0,12,52,0,12,52,0,12,52,0,12,52,0,15
15,0,52,12,0,52,12,55,52,12,55,52,12,0,52,12,0,52,12,0,52,12,0,52,12,0,52,12,0,52,12,0,52,12,0,52,12,0,15
15,0,0,0,0,15,15,0,0,0,0,15,15,0,0,0,0,0,0,0,0,0,0,0,0,0,0,0,0,0,0,0,0,0,0,0,0,0,15
15,0,12,52,0,12,52,55,12,52,0,12,52,0,12,52,0,12,52,0,12,52,0,12,52,0,12,52,0,12,52,0,12,52,0,12,52,0,15
15,0,52,12,0,52,12,55,52,12,0,52,12,0,52,12,0,52,12,0,52,12,0,52,12,0,52,12,0,52,12,0,52,12,0,52,12,0,15
15,0,0,0,0,0,0,0,15,15,0,15,15,0,15,15,0,15,15,0,15,15,0,0,0,0,0,0,0,0,0,0,0,0,0,0,0,0,15
15,0,12,52,0,12,52,0,12,52,0,12,52,0,12,52,0,12,52,55,12,52,0,12,52,0,12,52,0,12,52,0,12,52,0,12,52,0,15
15,0,52,12,0,52,12,0,52,12,0,52,12,0,52,12,0,52,12,55,52,12,0,52,12,0,52,12,0,52,12,0,52,12,0,52,12,0,15
15,0,0,0,0,0,0,0,0,0,0,15,15,0,0,0,0,0,0,0,0,0,0,0,0,0,0,0,0,0,0,0,0,0,0,0,0,0,15
15,0,12,52,0,12,52,0,12,52,0,12,52,0,12,52,0,12,52,0,12,52,0,12,52,0,12,52,55,12,52,55,12,52,0,12,52,0,15
15,0,52,12,0,52,12,0,52,12,0,52,12,0,52,12,0,52,12,0,52,12,0,52,12,0,52,12,55,52,12,55,52,12,0,52,12,0,15
15,0,0,0,0,0,0,0,0,0,0,0,0,0,0,0,0,15,15,0,0,0,0,0,0,0,0,0,0,0,0,0,0,0,0,0,0,0,15
15,0,12,52,0,12,52,0,12,52,0,12,52,0,12,52,0,12,52,0,12,52,0,12,52,0,12,52,0,12,52,0,12,52,0,12,52,0,15
15,0,52,12,0,52,12,0,52,12,0,52,12,0,52,12,0,52,12,0,52,12,0,52,12,0,52,12,0,52,12,0,52,12,0,52,12,0,15
15,0,0,0,0,0,0,0,0,0,0,0,0,0,0,0,0,0,0,0,0,0,0,0,0,0,0,0,0,0,0,0,0,0,0,0,0,0,15
15,0,12,52,0,12,52,0,12,52,0,12,52,0,12,52,0,12,52,0,12,52,0,12,52,0,12,52,0,12,52,0,12,52,0,12,52,0,15
15,0,52,12,0,52,12,0,52,12,0,52,12,0,52,12,0,52,12,0,52,12,0,52,12,0,52,12,0,52,12,0,52,12,0,52,12,0,15
15,0,0,0,0,0,0,0,0,0,0,0,0,0,0,0,0,0,0,0,0,0,0,0,0,0,0,0,0,0,0,0,0,0,0,0,0,0,15
15,15,15,15,15,15,15,15,15,15,15,15,15,15,15,15,15,15,15,15,15,15,15,15,15,15,15,15,15,15,15,15,15,15,15,15,15,15,15
